see	V
case	N
hear	V
test	N
take	V
video	N
surprise	V
anyone	N
miss	V
life	N
write	V
night	N
much	ADJ
year	N
try	V
problem	N
subject	N
minute	N
many	ADJ
time	N
head	N
give	V
something	N
mind	N
way	N
pass	V
people	N
kick	V
third	ADJ
carry	V
place	N
day	N
show	V
less	ADJ
possible	ADJ
available	ADJ
science	N
stage	N
work	N
deck	N
card	N
invite	V
watch	V
amazing	ADJ
remember	V
everything	N
brain	N
choose	V
pay	V
thing	N
eye	N
